NO textures/wall.xpm
SO textures/wall2.xpm
WE textures/wall3.xpm
EA textures/wall4.xpm
F 100,100,100
C 200,200,255

11111111
10000001
100N0 01
10000001
11111111

