NO textures/wall.xpm
SO textures/wall2.xpm
WE textures/wall3.xpm
EA textures/wall4.xpm
F 100,100,100
C 200,200,255

111111
1N0001
100001
111111

