NO textures/wall.xpm
SO textures/wall2.xpm
WE textures/wall3.xpm
EA textures/wall4.xpm
F 100,100,100
C 200,200,255

1111111111111111111111111
1000000000110000000000001
1011000001110000000000001
1001000000000000000000001
1111111111110000001110001
1000000000110000001110001
1111011111111011100000001
1111011111111011101010001
1100000011010101110000001
1000000000000000110000001
100000000N000000110101001
1100000111010101111101111
11110111 1110101 10111101
11111111 1111111 11111111

